12
25
0 0 0 0 0 0 0 0 0 0 0 0 0 0 0 0 0 0 0 0 0 0 0 6 0 
0 5 5 5 5 0 5 5 5 5 5 5 5 5 5 5 5 5 0 0 0 0 6 8 0 
0 0 0 5 0 0 5 0 0 0 0 0 0 0 0 5 5 5 5 0 6 6 8 0 0 
6 6 6 6 6 6 6 6 6 6 6 6 6 6 6 6 6 6 6 6 8 0 0 0 0 
0 0 0 5 0 0 0 5 5 5 0 0 5 0 0 5 0 0 5 0 0 0 0 0 0 
0 0 0 5 0 0 0 0 0 0 0 0 0 0 5 5 0 0 5 5 0 0 0 0 0 
0 0 0 5 0 0 0 0 0 0 0 0 0 5 5 0 0 0 0 5 5 5 0 0 0 
0 0 0 5 5 5 0 0 5 5 5 5 5 5 5 0 0 0 0 5 0 5 0 0 0 
0 0 0 0 0 5 5 5 5 5 0 0 0 5 5 0 0 0 0 5 5 5 0 0 0 
0 0 0 0 0 0 0 0 5 0 0 0 0 0 5 5 5 5 5 5 0 0 0 0 0 
0 0 0 0 0 0 0 0 5 5 5 5 5 5 5 0 0 0 0 0 0 0 0 0 0 
0 0 0 0 0 0 0 0 0 0 0 0 0 0 0 0 0 0 0 0 0 0 0 0 0 
